111111111111111111
100000000000000001
100C101C101C100001
100110111001000001
10000000000P000001
100C10100000000001
1E0000000000000001
111111111111111111