
1111111111111111111
1110111111111111011
111111111111111111111
111111111111E011111
11111111111P1111111
1011111111C11110111
1111111111111111111