111111111
111111111
111E1P1C1
111111111