1111111111
1CCCCCCCC1
1CCCECCCC1
1CCCPC1101
1CCCCC1CC1
1111111111